0 0 0 0 0 0 0 0 0 0 0 0 0 0 0 0 0 0 0 0 0 0 0 0 0 0 0 0 0 0 0 0 0 0 0 0 0 0 0 0 0 0 0 0 0 0 0 0 0 0 0 0 0 0 0 0 0 0 0 0 0 0 0 0 
0 1 1 1 1 1 1 1 1 1 1 1 1 1 1 1 1 3 3 3 1 1 2 2 2 2 2 2 2 2 2 2 2 2 2 2 2 1 1 1 1 1 1 1 1 1 1 1 1 1 1 1 1 1 1 1 1 1 1 1 1 1 1 0
0 1 1 1 1 1 1 1 1 1 4 1 1 1 1 1 1 3 3 3 1 1 2 2 2 2 2 2 2 2 2 2 2 2 2 2 1 1 1 1 1 1 1 1 1 1 1 1 1 1 1 1 1 1 1 1 1 1 1 1 1 1 1 0
0 1 1 1 1 1 1 1 1 4 4 1 1 1 1 1 1 3 3 3 1 1 2 2 2 2 2 2 2 2 2 2 2 2 2 2 2 1 1 1 1 1 1 54 54 54 58 54 54 1 54 58 54 54 54 54 1 54 54 54 58 54 54 0
0 1 1 1 1 1 1 1 1 1 1 1 1 1 1 1 1 3 3 3 1 1 2 2 2 2 2 2 2 2 2 2 2 2 2 2 2 2 2 1 1 1 1 54 54 54 54 54 54 1 54 54 54 54 54 54 1 54 54 54 54 54 54 0
0 5 5 5 5 1 1 1 1 1 1 1 1 1 1 1 1 3 3 3 1 1 1 2 2 2 2 2 2 2 2 2 2 2 2 1 2 2 1 1 1 1 1 50 50 50 50 50 50 1 50 50 50 50 50 50 1 50 50 50 50 50 50 0
0 8 8 8 5 5 5 5 1 1 1 1 1 1 1 1 1 3 3 3 1 1 1 1 2 2 2 2 2 1 1 2 2 1 1 1 1 1 1 1 1 1 1 50 50 52 50 56 50 1 50 56 50 52 56 50 1 50 56 50 56 52 50 0
0 8 8 8 8 8 8 5 5 5 1 1 1 1 1 1 1 3 3 3 1 1 1 1 1 1 1 1 1 1 1 1 1 1 1 1 1 1 1 1 1 1 1 50 50 52 50 50 50 1 50 50 50 52 50 50 1 50 50 50 50 52 50 0
0 8 8 8 8 8 8 8 8 5 1 1 1 4 1 1 1 3 3 3 1 1 1 1 1 1 1 1 1 1 1 1 1 1 1 1 1 1 1 1 1 1 1 1 1 3 1 1 1 1 1 1 1 3 1 1 1 1 1 1 1 3 1 0
0 5 5 5 8 8 8 8 8 5 5 1 1 1 1 1 1 3 3 3 1 1 1 1 1 5 5 5 5 1 1 1 1 1 1 1 1 1 1 1 3 3 3 3 3 3 3 3 3 3 3 3 3 3 3 3 3 3 3 3 3 3 3 0
0 1 1 5 5 8 8 8 8 5 5 1 1 1 1 1 1 3 3 3 1 1 1 5 5 5 8 8 5 5 5 5 1 1 54 58 54 54 54 1 3 3 3 3 3 3 3 3 3 3 3 3 3 3 3 3 3 3 3 3 3 3 3 0
0 1 1 1 5 8 8 8 8 5 5 1 1 1 1 1 1 3 3 3 1 1 1 5 8 8 8 8 8 8 8 5 1 1 54 54 54 54 54 1 3 3 3 3 3 3 3 3 3 3 3 3 3 3 3 3 3 3 3 3 3 3 3 0
0 1 1 1 5 5 8 8 8 8 5 5 1 1 1 1 1 3 3 3 1 1 1 5 8 8 8 8 8 8 8 5 1 1 50 50 50 50 50 1 3 3 1 1 1 1 1 1 1 1 1 1 1 1 1 1 1 1 1 1 1 1 1 0
0 1 1 1 1 5 8 8 8 8 5 5 1 1 1 1 1 3 3 3 1 1 1 5 8 8 8 8 8 8 8 5 1 1 50 52 50 56 50 1 3 3 1 6 6 6 6 6 6 1 6 6 6 6 6 6 1 6 6 6 6 6 6 0
0 1 1 1 1 5 8 8 8 8 8 5 5 1 1 1 1 3 3 3 1 1 1 5 5 8 8 8 8 8 5 5 1 1 50 52 50 50 50 1 3 3 1 6 6 6 6 6 6 1 6 6 6 6 6 6 1 6 6 6 6 6 6 0
0 1 1 1 1 5 5 8 8 8 8 8 5 5 1 1 1 3 3 3 1 1 1 1 5 8 8 8 5 5 5 1 1 1 1 3 1 1 1 1 3 3 1 6 6 6 6 6 6 1 6 6 6 6 6 6 1 6 6 6 6 6 6 0
0 1 1 1 1 5 5 8 8 8 8 8 5 5 1 1 1 3 3 3 1 1 1 1 5 5 8 8 5 5 1 1 3 3 3 3 3 3 3 3 3 3 1 6 6 6 6 6 6 1 6 6 6 6 6 6 1 6 6 6 6 6 6 0
0 1 1 1 1 1 5 5 8 8 8 8 8 5 5 1 1 3 3 3 1 1 1 1 1 5 5 5 5 1 1 3 3 3 3 3 3 3 3 3 3 3 1 6 6 6 6 6 6 1 6 6 6 6 6 6 1 6 6 6 6 6 6 0
0 1 1 1 1 1 5 5 8 8 8 8 8 5 5 1 1 3 3 3 1 1 1 1 1 1 1 1 1 1 1 1 1 1 1 1 1 1 1 1 3 3 1 6 6 6 6 6 6 1 6 6 6 6 6 6 1 6 6 6 6 6 6 0
0 1 1 1 1 1 5 5 8 8 8 8 8 5 5 1 1 3 3 3 1 1 1 1 1 1 1 1 1 1 1 1 1 1 1 1 1 1 1 1 3 3 1 6 6 6 6 6 6 1 6 6 6 6 6 6 1 6 6 6 6 6 6 0
0 1 1 1 1 1 5 5 8 8 8 8 8 5 5 1 1 3 3 3 1 1 1 1 1 1 1 1 1 1 1 1 1 1 1 1 1 1 1 1 3 3 1 6 6 6 6 6 6 1 6 6 6 6 6 6 1 6 6 6 6 6 6 0
0 1 1 1 1 1 5 5 8 8 8 8 8 5 5 1 1 3 3 3 1 1 1 1 1 1 1 1 1 1 1 1 1 1 1 1 1 1 1 1 3 3 1 1 1 1 1 1 1 1 1 1 1 1 1 1 1 1 1 1 1 1 1 0
0 1 1 1 1 1 5 5 8 8 8 8 8 5 5 1 1 3 3 3 3 3 3 3 3 3 3 3 3 3 3 3 3 3 3 3 3 3 3 3 3 3 3 3 3 3 3 3 3 3 3 3 3 3 3 3 3 3 3 3 3 3 3 0
0 1 1 1 1 5 5 8 8 8 8 8 5 5 1 1 1 3 3 3 3 3 3 3 3 3 3 3 3 3 3 3 3 3 3 3 3 3 3 3 3 3 3 3 3 3 3 3 3 3 3 3 3 3 3 3 3 3 3 3 3 3 3 0
0 1 1 1 1 5 5 8 8 8 8 8 5 5 1 1 1 3 3 3 1 1 1 1 1 1 1 1 1 1 1 1 1 1 1 1 1 1 1 1 1 1 1 1 1 1 1 1 1 1 1 3 3 3 1 1 1 1 1 1 1 1 1 0
0 1 1 1 5 5 8 8 8 8 8 5 5 1 1 1 1 3 3 3 1 1 1 1 1 1 1 1 1 1 1 1 1 1 1 4 1 1 1 1 1 1 1 1 1 7 7 7 7 1 1 3 3 3 1 1 1 7 7 7 7 7 7 0
0 1 1 1 5 5 8 8 8 8 8 5 5 1 1 1 1 3 3 3 1 1 1 1 1 1 1 1 1 1 1 1 1 1 1 4 4 1 1 1 1 1 1 1 7 7 7 7 7 7 1 3 3 3 1 1 7 7 7 7 7 7 7 0
0 1 1 5 5 8 8 8 8 8 5 5 5 5 1 1 1 3 3 3 1 1 1 1 1 1 1 1 1 1 1 1 1 1 1 1 1 1 1 1 1 1 1 1 1 1 7 7 7 7 1 3 3 3 1 7 7 7 7 7 7 7 7 0
0 1 1 5 5 5 5 5 5 5 5 5 5 5 5 1 1 3 3 3 1 1 1 1 1 1 1 1 1 1 1 1 1 1 1 1 1 1 1 1 1 1 1 1 7 7 7 7 7 7 7 3 3 3 7 7 7 7 7 7 7 7 7 0
0 1 1 5 5 8 8 8 8 8 5 5 5 5 5 1 1 3 3 3 1 1 1 1 1 1 1 1 1 1 1 1 1 1 1 1 1 1 1 1 1 1 1 7 7 7 7 7 7 7 7 3 3 3 7 7 7 7 7 7 7 7 7 0
0 1 1 1 5 5 8 8 8 8 8 5 5 5 5 1 1 3 3 3 1 1 1 1 1 1 1 1 1 1 1 1 1 1 1 1 1 1 1 1 1 1 7 7 7 7 7 7 7 7 7 3 3 3 7 7 7 7 7 7 7 7 7 0
0 0 0 0 0 0 0 0 0 0 0 0 0 0 0 0 0 0 0 0 0 0 0 0 0 0 0 0 0 0 0 0 0 0 0 0 0 0 0 0 0 0 0 0 0 0 0 0 0 0 0 0 0 0 0 0 0 0 0 0 0 0 0 0 